DOCK	D AA K
EIGHT	EY T
FIVE	F AY V
FOUR	F AO R
NINE	N AY N
ONE	W AH N
ONE(2)	HH W AH N
ROBOMUSE    R AA B AH M Y UW Z
ROBOMUSE(2) R OW B OW M Y UW Z
SEVEN	S EH V AH N
SHUTDOWN	SH AH T D AW N
SIX	S IH K S
START	S T AA R T
START(2)    S T AA T
STOP	S T AA P
TEN	T EH N
THREE	TH R IY
TWO	T UW
UNDOCK	AH N D AA K
ZERO	Z IY R OW
